111111111111111111111111
120000000000100000000021
101110111110101111101101
101110000000000000001101
100000101111111111000001
101110100200100201011101
100000110110101101011101
101110110110001101011101
100000110111011101000001
101101110100000101001101
101101110111111101101101
100001000000300000000001
101101011111011111011101
101101010020010002001101
100000000111010111100001
101110111111010000001101
101110000111010111111101
101110110001000000010101
101110110100010101010101
100000110111010101010001
101110110000010100000101
101110111011110111111101
120000000000000000000021
111111111111111111111111